..##..##..##..#
..##..##..##..#
..##..##..##..#
..##..##..##..#
..##..##..##..#
...............
........##.....
##..##..##.....
##..######..##.
##..##..##..##.
##..##..##..##.
........##.....
####....##..##.
####....##..##.
...............
